111111111111111
11111M000111111
10E10C0M01C0001
101101100111001
10C00010C001011
100010101000011
10C01P00100C011
111111111111111
