111111111111111
111110000111111
10E10C0M01C0001
101101100111001
10C00E10C001011
10001PM01000011
10001C00100C011
111111111111111
