11111111111111111111111111111
1C0000000000000000000000001M1
10000001111100111100000E00111
11110001M0M1001M0100000000001
1P000001M1M1001MM100111110001
11110001M0M100111100100010001
10000001111100000000101010001
1C0000000000000000001M0010001
11111111111111111111111111111