1111111111111111111111111111
1ECECECECECECECECECECECECEC1
1CECECECECECECECECECECECECE1
1ECECECECECECECECECECECECEC1
1PECECECECECECECECECECECECE1
1ECECECECECECECECECECECECEC1
1CECECECECECECECECECECECECE1
1ECECECECECECECECECECECECEC1
1111111111111111111111111111